1|1|1|1|1
1|2|2|2|1
1|18|8|4|1
1|2|2|2|1
1|1|1|1|1