##
第一关
1|1|1|1|1
1|2|2|2|1
1|18|10|4|1
1|2|2|2|1
1|1|1|1|1
##
第二关
1|1|1|1|1|1|1|1|1
1|1|1|2|4|12|2|1|1
1|1|1|4|4|2|10|18|1
1|2|2|12|1|2|2|1|1
1|2|2|2|10|2|2|2|1
1|1|1|1|10|2|2|2|1
1|1|1|1|2|2|1|1|1
1|1|1|1|1|1|1|1|1
