##
第一关
1|1|1|1|1
1|2|2|2|1
1|18|10|4|1
1|2|2|2|1
1|1|1|1|1
##
第二关
1|1|1|1|1
1|2|2|2|1
1|18|10|4|1
1|2|2|2|1
1|1|1|1|1
